11111111111111111111
1C0CC0C111C0CC0C11E1
1001110111C0CC0C0001
10000C0000C0CC0C0001
1000000C00C0CC0C1111
100C000C0CC0CC0C0001
1C0CC0C111C0CC0C1111
10P1110111C0CC0C1111
10000C0000C0CC0C1111
11111111111111111111
