1111111111111111
1P10000000000001
1011111111111101
10100000C0000101
1010011111100111
1010010000100001
10000100001000C1
11111110001C1111
1000000000100001
1000000000100CE1
1111111111111111
