1111111111
1P00CC00E1
101100C001
1000C00001
1000000001
1111111111
