1111111111111111111111111111111111111111
1C0CC000000000000000000000C111C0CC0C11E1
1001110111C0CC000000000CCCC00000000C0001
10000C0000C0CC0C000000C0000000C000000001
1000000C00C0CC0C00000C000000011111111111
100C000C0CC0CC0C0000000000000000C000C001
1C0CC0C111C0CC0C111000000000000000C00001
101110111C0CC0C1111C00000000C00000000001
10000C0000C0CC0C11111000000C000000C00001
100000000000000000000C0000000C0000000C01
1C0CC0C111C0CC0C11100C0000000C0000000C01
1001110111C0CC0C00000C0000000C0000000C01
10000C0000C0CC0C00000C0000000C0000000C01
1000000C00C0CC0C11100C0000000C0000000C01
100C000C0CC0CC0C00000C0000000C0000000C01
1C0CC0C111C0CC0C11100C0000000C0000000C01
10P1110111C0CC0C11100C0000000C0000000C01
10000C0000C0CC0C111111111111111111111111
1111111111111111111111111111111111111111
